A portfolio website is a unique way to showcase your work and 
let others know about yourself.
It's like an evergreen platform for your projects, case studies, and 
information about you. 
In addition, it's one of the best ways to express your personality, experience, and
capabilities.

HTML TAGS USED:

<!DOCTYPE> 	Defines the document type
<audio>	Defines embedded sound content
<b>	Defines bold text
<i> Defines italic text
<u>Defines underline text
<body>	Defines the document's body
<br>	Defines a single line break
<button>	Defines a clickable button
<center>	Defines centered text
<col>	Specifies column properties for each column within a <colgroup> element 
<div>	Defines a section in a document
<font>	Defines font, color, and size for text
<footer>	Defines a footer for a document or section
<form>	Defines an HTML form for user input
<frame>	Defines a window (a frame) in a frameset
<h1> to <h6>	Defines HTML headings
<head>	Contains metadata/information for the document
<header>	Defines a header for a document or section
<hr>	Defines a thematic change in the content
<html>	Defines the root of an HTML document
<img>	Defines an image
<input>	Defines an input control
<label>	Defines a label for an <input> element
<main>	Specifies the main content of a document
<p>	Defines a paragraph
<section>	Defines a section in a document
<source>	Defines multiple media resources for media elements (<video> )
<span>	Defines a section in a document
<style>	Defines style information for a document
<table>	Defines a table
<td>	Defines a cell in a table
<th>	Defines a header cell in a table
<title>	Defines a title for the document
<tr>	Defines a row in a table
<video>	Defines embedded video content

CREATIVE

USED PROGRESS BAR FOR SKILLS PROFICIENCY
